 1 2 2 2 3
 4 0 0 0 4
 4 0 0 0 4
 4 0 0 0 4
 5 2 2 2 6